{
    "name": "medium",
    "description": "12x12 maze with loops and multiple paths to explore",
    "cell_size": 0.3,
    "grid": [
        [1,1,1,1,1,1,1,1,1,1,1,1],
        [1,0,0,0,1,0,0,0,0,0,0,1],
        [1,0,1,0,0,0,1,1,0,1,0,1],
        [1,0,1,1,1,0,1,0,0,1,0,1],
        [1,0,0,0,1,0,0,0,1,1,0,1],
        [1,1,1,0,1,1,1,0,1,0,0,1],
        [1,0,0,0,0,0,1,0,0,0,1,1],
        [1,0,1,1,1,0,1,1,1,0,1,1],
        [1,0,1,0,0,0,0,0,1,0,0,1],
        [1,0,1,0,1,1,1,0,1,1,0,1],
        [1,0,0,0,0,0,0,0,0,0,0,1],
        [1,1,1,1,1,1,1,1,1,1,1,1]
    ]
}