{
    "width": 5,
    "height": 6,
    "maze": [
        [0, 1, 1, 1, 1],
        [1, 0, 0, 0, 1],
        [1, 0, 1, 0, 1],
        [1, 0, 0, 0, 1],
        [1, 1, 1, 1, 1],
        [0, 0, 0, 1, 1]
    ]
}