{
    "width": 5,
    "height": 7,
    "maze": [
        [1, 1, 1, 1, 1],
        [1, 0, 0, 0, 1],
        [1, 0, 1, 0, 1],
        [1, 0, 0, 0, 1],
        [1, 0, 1, 0, 1],
        [1, 0, 0, 0, 1],
        [1, 1, 1, 1, 1]
    ]
}